11111111111111111111
10000000011000000011
10000000010000000001
11111111010001100111
11000010011101100001
11000010010001111001
11111111010111100001
10000000010001110011
10000000010001100001
10111111111011101101
10000000000001100001
10001000010001110001
11111111111111100001
11111111111111100001
11100000000000000011
11000111111111111111
10000100010000100001
11000000010010000001
11110000000000100001
11111111111111111111