11111111111111111111
10000010000001000001
10000000000001000001
11110010010001000001
10000010010001000001
10000010011001000001
10011110010001010101
10010010010001010101
10011110010001010101
10000000010111000001
10000000010001101011
11111111111011000001
10000000010001010101
10000100010001000001
10000100000001101011
10011111111111000001
10010001000100000001
10000101010101000011
10000100010001000111
11111111111111111111