11111111111111111111
10000010001000001001
10000000100000100001
11110111111101111001
10000000000000000001
10000000101000000001
10011111111111111111
10000000000000000011
11100111100111100001
11111111111100000011
10000000000100111111
11011111110100000001
10001111000100000101
11011001000111110101
10001001011100010001
11011001000101010101
10001001000101010101
10001111000101010001
10001111000001000001
11111111111111111111