11111111111111111111
10000010000100000001
10111010000100000001
10001000110101111111
10101010100100000001
10001000101101010101
10001010100101010101
10001000110100000001
11111111100111111001
10000100000010001001
10010001000000100001
10011111100111111111
10000000101100001001
10000010100101101001
11111110110100100001
11100000100100101001
10001111101101100001
10001000100000101001
10000000100000100001
11111111111111111111